>Mabuya agilis, SW Brazil; Mato Grosso do Sul
TTGTCTTTTAAATAAAGACCTGTATGAATGGCTGAATGAGGATAAACCTGTCTCTTATAA
CTAATCAGTGAAACTGATCTCCCAGTACAAAAGCTGGAATATACACATAAGACGAGAAGA
CCCTGTGGAGCTTAAAAC-AAACCACTAAACAA-----GT--ATACCACTACCTTAGTGT
AC-GTTTTCAGTTGGGGCGACTTCGGAATAAAATGAAACTTCCGAGCACAGAGGCAC-TT
CCTCTAACTAAGGCCAACAAGCCAAAGACCC---ATAAACGACCCGGCC---TTGCCGAT
CAACGAACCAAGTTACCCCAGGGATAACAGCGCAATCTTCTTCGAGAGCCCTTATCAACA
AGAAGGTTTACGACCTCGATGTTGGATCAGGACACCCAAATGGTGCAGCCGCTATTAAAG
GTTCGTTTGTTCAACGATT
>Mabuya capensis, South Africa; Kuga Mts. E. Cape
TTGTCTTCTAAATAAAGACCAGTATGAACGGCTAAATGAGGACAAACCTGTCTCTTATAA
TTAATCAGTGAAACTGATCTCCCAGTACAAAAGCTGGGATTTTAACATAAGACGAGAAGA
CCCCGTGGAGCTTGAAAT--TTCCACTAACCC-----------ATACGG-GCCCTAGTTT
ACTATTTTAAGTTGGGGCGACTTCGGAACAAAACAAAACTTCCGAGCACAGAACCAC-CA
CTTCTAACCGAGGCCAACAAGCCTAAGTATA---AA--CTGACCCGGCCC--ACGCCGAT
CAACGAACCAAGTTACCCCGGGGATAACAGCGCTATCTTCTTCAAGAGTCCCTATCAACA
AGAAGGTTTACGACCTCGATGTTGGATCAGGACACCCAAATGGTGCAGCCGCTATTAAAG
GTTCGTTTGTTCAACGATT
>Mabuya vittata, Turkey; Osmandere
TTGTCTTCTAAATAAAGACCTGTATGAACGGCTAAATGAGGATAAACCTGTCTCTTATAA
CCAACCAGTGAAACTGATCTCCCAGTACAAAAGCTGGAATCAACCCATAAGACGAGAAGA
CCCTGCGGAGCTTAAAAC-AAACCACTAATTAATAT------CATCTTA-ACCCTAGTGA
AATGTTTTCAGTTGGGGCGACTTCGGAATAAAACACAACTTCCGAGCACAGAACCAC-TA
ATTCTAACCAAGGCCAACAAGCCAAAGTA-T---AAT-ATGACCCGGCAC--ATGCCGAT
CAACGAACCAAGTTACCCCAGGGATAACAGCGCTATCCTCTTCAAGAGTCCCTATCAACA
AGAGGGTTTACGACCTCGATGTTGGATCAGGACACCCAAATGGTGCAGCCGCTATTAAAG
GTTCGTTTGTTCAACGATT
